Date,Merchant,Debit,Credit,Balance
2025-01-18,AMAZON MARKETPLACE,79.99,,1245.67
2025-01-17,COSTCO WHOLESALE,156.43,,1325.66
2025-01-15,PAYMENT RECEIVED,,500.00,1482.09
2025-01-12,UBER RIDE,22.50,,982.09
2025-01-10,CHIPOTLE,14.75,,1004.59
2025-01-08,DELTA AIRLINES,345.00,,1019.34
2025-01-05,TARGET,67.89,,1364.34
2025-01-03,SHELL,45.00,,1432.23
